1111111111111
1001000000C11
1000011111001
1P00111E00001
1111111111111